RSA = "countries/Russia.txt"
TAI = "countries/Taiwan.txt"
PRC = "countries/ComChina.txt"
HAM = "countries/Hamas.txt"
WBK = "countries/WestBank.txt"
LES = "countries/Lesotho.txt"
ESW = "countries/Eswatini.txt"
TNS = "countries/Transnistria.txt"
ANT = "countries/Antarticia.txt"
SIG = "countries/Singapore.txt"
KIR = "countries/Kiribati.txt"
BRU = "countries/Brunei.txt"
TIM = "countries/Timor-Leste.txt"
VAN = "countries/Vanuatu.txt"
TUV = "countries/Tuvalu.txt"
ASM = "countries/AmerSamoa.txt"
HEZ = "countries/Hezbollah.txt"
SML = "countries/Somaliland.txt"
ISI = "countries/ISIS.txt"
ALS = "countries/AlShab.txt"
HOU = "countries/Houthis.txt"
BOK = "countries/BokoHar.txt"
ANB = "countries/AntBar.txt"
SAO = "countries/SaoTome.txt"
BAB = "countries/Barbados.txt"
NCY = "countries/NorCyprus.txt"
DMC = "countries/Dominica.txt"
GRA = "countries/Grenada.txt"
LIE = "countries/Liech.txt"
MAR = "countries/Marshall.txt"
MRS = "countries/Mauritius.txt"
MNC = "countries/Monaco.txt"
NAU = "countries/Nauru.txt"
NKR = "countries/NorKorea.txt"
PLU = "countries/Palau.txt"
SKN = "countries/StKitts.txt"
STL = "countries/StLucia.txt"
STV = "countries/StVincent.txt"
SAN = "countries/SanMarino.txt"
SEY = "countries/Seychelles.txt"
SSU = "countries/SouSudan.txt"
VAT = "countries/Vatican.txt"
CKI = "countries/CookIsles.txt"
NIU = "countries/Niue.txt"
SOS = "countries/SouOssetia.txt"
ADR = "countries/Andorra.txt"
GIB = "countries/Gibi.txt"
HNK = "countries/HongKong.txt"
MAC = "countries/Macau.txt"
COM = "countries/Comoros.txt"
MTS = "countries/Montserrat.txt"
TKC = "countries/Turks.txt"
VGI = "countries/USVir.txt"
ALD = "countries/Aland.txt"
FAR = "countries/Faroe.txt"
JAO = "countries/JewOblast.txt"
ADY = "countries/Adygea.txt"
BKS = "countries/Bashkort.txt"
CHE = "countries/Chechnya.txt"
CHV = "countries/Chuvashia.txt"
DPR = "countries/Donetsk.txt"
ING = "countries/Ingushetia.txt"
KAB = "countries/Kabardino.txt"
KCC = "countries/Karachay.txt"
KHK = "countries/Khakassia.txt"
MOR = "countries/Mordovia.txt"
KHM = "countries/Khanty.txt"
VOJ = "countries/Vojvodina.txt"
ZAP = "countries/Zapatista.txt"
SCG = "countries/SouthCog.txt"
BSG = "countries/BasCog.txt"
MMB = "countries/Mombasa.txt"
CRV = "countries/Caprivi.txt"
CAP = "countries/Cape.txt"
VLK = "countries/Volkstaat.txt"
DAR = "countries/Darfur.txt"
ZZB = "countries/Zanzibar.txt"
STK = "countries/SouthTurk.txt"
TMA = "countries/Talysh.txt"
SAZ = "countries/SouthAzer.txt"
TME = "countries/Turkmenli.txt"
OKI = "countries/Okinawa.txt"
PST = "countries/Pashtunistan.txt"
SIB = "countries/Siberia.txt"
URA = "countries/Ural.txt"
AAS = "countries/AutoSyr.txt"
WAR = "countries/WestArm.txt"
BKO = "countries/Bektashi.txt"
FLA = "countries/Flanders.txt"
WLL = "countries/Wallonia.txt"
EUP = "countries/Eupen.txt"
MRV = "countries/Moravia.txt"
FFL = "countries/FrenchFlan.txt"
ASL = "countries/Lorraine.txt"
ALK = "countries/Alaska.txt"
WAS = "countries/Washington.txt"
ORE = "countries/Andorra.txt"
CAL = "countries/California.txt"
IDH = "countries/Idaho.txt"
UTA = "countries/Utah.txt"
NVA = "countries/Nevada.txt"
ARI = "countries/Arizona.txt"
MTN = "countries/Montana.txt"
CLR = "countries/Colorado.txt"
WYO = "countries/Wyoming.txt"
NMX = "countries/NewMex.txt"
TEX = "countries/Texas.txt"
NDK = "countries/NorthDakota.txt"
SDK = "countries/SouthDakota.txt"
NEB = "countries/Nebraska.txt"
KAN = "countries/Kansas.txt"
OKC = "countries/Oklahoma.txt"
MIN = "countries/Minnesota.txt"
WIS = "countries/Wisconsin.txt"
IWA = "countries/Iowa.txt"
MSO = "countries/Missouri.txt"
ARK = "countries/Arkansas.txt"
LOU = "countries/Louisiana.txt"
MSI = "countries/Mississippi.txt"
TEN = "countries/Tenessee.txt"
KTY = "countries/Kentucky.txt"
IND = "countries/Indiana.txt"
MIC = "countries/Michigan.txt"
OHI = "countries/Ohio.txt"
NYK = "countries/NewYork.txt"
PNS = "countries/Pennsylvania.txt"
WVA = "countries/WestVirgin.txt"
VGA = "countries/Virginia.txt"
ABM = "countries/Alabama.txt"
GEA = "countries/Georgia.txt"
FLO = "countries/Flordia.txt"
SCA = "countries/SouthCar.txt"
NCA = "countries/NorthCar.txt"
MDL = "countries/Maryland.txt"
WDC = "countries/WashingtonDC.txt"
DLW = "countries/Delaware.txt"
NJY = "countries/NewJersey.txt"
MSS = "countries/Massachusetts.txt"
RID = "countries/RhodeIsland.txt"
VTM = "countries/Vermont.txt"
NHM = "countries/NewHampshire.txt"
MNE = "countries/Maine.txt"
CCT = "countries/ConCut.txt"
LOS = "countries/LosAngeles.txt"
SSB = "countries/SanFran.txt"
NYC = "countries/NYC.txt"
BCV = "countries/BritCol.txt"
YKN = "countries/Yukon.txt"
NWT = "countries/NWTerri.txt"
ABT = "countries/Albertia.txt"
SAK = "countries/Chewan.txt"
MBA = "countries/Manitoba.txt"
NUN = "countries/Nunavut.txt"
ONT = "countries/Ontario.txt"
LAB = "countries/Labrador.txt"
NFL = "countries/Newfoundland.txt"
NBW = "countries/NewBrunswick.txt"
NVS = "countries/NovaScotia.txt"
PEW = "countries/PrinceED.txt"
JRY = "countries/Jersey.txt"
GUS = "countries/Guernsey.txt"
SEA = "countries/Seattle.txt"
ASN = "countries/Austin.txt"
